4 13 32
################################
#p    * **    *   3   4        #
# # # #*# # # # # # # # # # #  #
#      ** * *  *   * ** 3 *   #
# # # # # #*# # # # # # #*# #  #
#*   * *    *b* *   **         #
# # # # # # # # # # # # # #*#  #
#    *     *        *    **  3#
# #*# # #*#*#*#*# # #1# # #*#  #
#        * 4 *2*    *   *      #
#*# # # # # # # # # # #*# # #* #
#x*    * **    ** ***     1    #
################################